,File,syllable,type,min.freq,max.freq,freq.range,duration,location,species
1,200612_009_4,1,A,2519,2848,329,0.023157363,A,grey
2,200612_009_4,2,H,1763,2404,641,0.041352434,A,grey
3,200612_009_4,3,E,1522,2850,1328,0.153831055,A,grey
4,200612_009_4,4,G,2758,3206,448,0.148868763,A,grey
5,200612_009_4,5,E,1522,2885,1363,0.167063834,A,grey
6,200612_009_9,1,A,2484,2645,161,0.025670963,A,grey
7,200612_009_9,2,G,2925,3327,402,0.067930356,A,grey
8,200612_009_9,3,E,1883,3166,1283,0.123029423,A,grey
9,200612_009_9,4,C,1442,2605,1163,0.080006864,A,grey
10,200612_009_9,5,G,2885,3366,481,0.070949483,A,grey
11,200612_010_4,1,A,2524,2967,443,0.028119655,A,grey
12,200612_010_4,2,H,1681,2363,682,0.051277018,A,grey
13,200612_010_4,3,G,2244,3008,764,0.112478621,A,grey
14,200612_010_4,4,E,1601,2805,1204,0.155485152,A,grey
15,200612_010_4,5,G,2526,3209,683,0.120749108,A,grey
16,200612_010_4,6,H,1682,2443,761,0.052931116,A,grey
17,200612_010_4,7,E,1522,3005,1483,0.162101542,A,grey
18,200612_010_5,1,A,2400,2845,445,0.037217191,A,grey
19,200612_010_5,2,D,1763,2389,626,0.049622921,A,grey
20,200612_010_5,3,E,1482,3087,1605,0.186085953,A,grey
21,200612_010_5,4,G,2685,3050,365,0.143906471,A,grey
22,200612_010_5,5,E,1402,2929,1527,0.173680223,A,grey
23,200612_010_5,6,G,2518,3005,487,0.153831055,A,grey
24,200612_010_5,7,D,1723,2364,641,0.062028651,A,grey
25,200612_010_5,8,E,1480,2961,1481,0.173680223,A,grey
26,200612_011_3,1,E,1442,2923,1481,0.153831055,A,grey
27,200612_011_3,2,B,1644,3046,1402,0.128658374,A,grey
28,200612_011_3,3,E,1480,2926,1446,0.15052286,A,grey
29,200612_011_6,1,A,2484,2901,417,0.036390142,A,grey
30,200612_011_6,2,H,1723,2324,601,0.061201602,A,grey
31,200612_011_6,3,E,1482,2885,1403,0.152176957,A,grey
32,200612_011_6,4,G,2765,3006,241,0.100899939,A,grey
33,200612_011_6,5,E,1601,2924,1323,0.153831055,A,grey
34,200612_012_1,1,A,2565,2760,195,0.02481146,A,grey
35,200612_012_1,2,H,1562,2363,801,0.046314726,A,grey
36,200612_012_1,3,I,1963,3045,1082,0.115786815,A,grey
37,200612_012_1,4,E,1482,2845,1363,0.145560568,A,grey
38,200612_012_2,1,A,2444,2885,441,0.03142785,A,grey
39,200612_012_2,2,H,1681,2365,684,0.046314726,A,grey
40,200612_012_2,3,I,1923,3047,1124,0.109170426,A,grey
41,200612_012_2,4,E,1520,2766,1246,0.153831055,A,grey
42,200612_013_1,1,A,2124,2526,402,0.036390142,A,grey
43,200612_013_1,2,A,2080,2441,361,0.044660629,A,grey
44,200612_013_1,3,B,2364,2965,601,0.127365497,A,grey
45,200612_013_1,4,A,2043,2362,319,0.03142785,A,grey
46,200612_013_1,5,B,2250,2968,718,0.124057302,A,grey
47,200612_013_1,6,E,1600,2885,1285,0.140598276,A,grey
48,200612_013_1,7,B,2404,2920,516,0.087498043,A,grey
49,200612_013_1,8,I,1561,2805,1244,0.076987737,A,grey
50,200612_013_2,1,A,2164,2605,441,0.039698337,A,grey
51,200612_013_2,2,A,2243,2601,358,0.049622921,A,grey
52,200612_013_2,3,B,1481,3088,1607,0.203453976,A,grey
53,200612_013_2,4,A,2124,2315,191,0.054585213,A,grey
54,200612_013_2,5,B,1480,2047,567,0.198491684,A,grey
55,200612_013_2,6,E,1439,2965,1526,0.171199077,A,grey
56,200612_013_2,7,E,1402,2880,1478,0.166236785,A,grey
57,200612_013_2,8,L,1683,2885,1202,0.230746582,A,grey
58,200612_014_5,1,A,2364,2845,481,0.042179483,A,grey
59,200612_014_5,2,A,2324,2688,364,0.054585213,A,grey
60,200612_014_5,3,B,1521,3243,1722,0.218340852,A,grey
61,200612_014_5,4,A,1963,2441,478,0.044660629,A,grey
62,200612_014_5,5,B,1362,3040,1678,0.210897414,A,grey
63,200612_014_5,6,E,1480,3006,1526,0.168717931,A,grey
64,200612_014_5,7,L,1603,2969,1366,0.104677584,A,grey
65,200612_014_5,8,M,1242,3366,2124,0.10868857,A,grey
66,200612_014_5,9,B,1482,3041,1559,0.183604807,A,grey
67,200612_014_6,1,A,2284,2565,281,0.052104067,A,grey
68,200612_014_6,2,A,2284,2645,361,0.052104067,A,grey
69,200612_014_6,3,B,1443,3206,1763,0.223303144,A,grey
70,200612_014_6,4,A,1923,2364,441,0.052104067,A,grey
71,200612_014_6,5,B,1400,3125,1725,0.210897414,A,grey
72,200612_014_6,6,E,1402,2845,1443,0.178642515,A,grey
73,200612_014_6,7,L,1723,2885,1162,0.094102768,A,grey
74,200612_014_6,8,M,1161,3289,2128,0.10868857,A,grey
75,200612_014_6,9,B,1639,3047,1408,0.188567099,A,grey
76,200612_014_6,10,A,2164,2365,201,0.033374409,A,grey
77,200612_014_6,11,B,1442,2963,1521,0.186085953,A,grey
78,200612_017_9,1,A,2645,2965,320,0.034736045,A,grey
79,200612_017_9,2,H,1602,2404,802,0.059547505,A,grey
80,200612_017_9,3,I,1923,3008,1085,0.129019594,A,grey
81,200612_017_9,4,E,1404,2923,1519,0.178642515,A,grey
82,200612_017_9,5,G,2579,2968,389,0.142252373,A,grey
83,200612_017_9,6,H,1640,2406,766,0.051277018,A,grey
84,200612_017_9,7,E,1522,2885,1363,0.15713925,A,grey
85,200612_017_10,1,A,2644,2925,281,0.043006531,A,grey
86,200612_017_10,2,H,1603,2325,722,0.049622921,A,grey
87,200612_017_10,3,I,1963,2964,1001,0.120749108,A,grey
88,200612_017_10,4,E,1441,2845,1404,0.158793347,A,grey
89,200612_017_10,5,G,2489,3006,517,0.123535577,A,grey
90,200612_017_10,6,H,1485,2364,879,0.049622921,A,grey
91,200612_017_10,7,E,1490,2887,1397,0.15052286,A,grey
92,200612_018_5,1,A,2725,2887,162,0.036390142,A,grey
93,200612_018_5,2,H,1644,2366,722,0.061201602,A,grey
94,200612_018_5,3,I,1883,2969,1086,0.133981886,A,grey
95,200612_018_5,4,E,1560,2966,1406,0.150948419,A,grey
96,200612_018_5,5,G,2565,3127,562,0.127365497,A,grey
97,200612_018_5,6,H,1682,2404,722,0.05623931,A,grey
98,200612_018_5,7,E,1402,2888,1486,0.149550765,A,grey
99,200612_018_6,1,A,2565,3006,441,0.036390142,A,grey
100,200612_018_6,1,H,1641,2404,763,0.0628557,A,grey
101,200612_018_6,1,I,1959,2885,926,0.114132718,A,grey
102,200612_018_6,1,E,1440,2845,1405,0.150161525,A,grey
103,200612_018_6,1,G,2566,3087,521,0.118091087,A,grey
104,200612_018_6,1,H,1563,2325,762,0.057082045,A,grey
105,200612_018_6,1,E,1481,2884,1403,0.15478604,A,grey
106,200612_019_3,1,G,2645,3441,796,0.127365497,A,grey
107,200612_019_3,2,E,1442,3007,1565,0.145560568,A,grey
108,200612_019_4,1,H,1723,2164,441,0.039698337,A,grey
109,200612_019_4,2,E,1521,2929,1408,0.15735605,A,grey
110,200612_019_4,3,G,2725,3086,361,0.102554037,A,grey
111,200612_019_4,4,E,1482,2968,1486,0.152505667,A,grey
112,200612_021_4,1,A,2525,2963,438,0.036390142,A,grey
113,200612_021_4,2,E,1564,3082,1518,0.151494728,A,grey
114,200612_021_4,3,G,2761,3166,405,0.114132718,A,grey
115,200612_021_4,4,E,1524,2927,1403,0.15713925,A,grey
116,200612_021_4,5,E,1522,2945,1423,0.153831055,A,grey
117,200612_021_9,1,A,2484,3003,519,0.024153016,A,grey
118,200612_021_9,2,E,1405,3086,1681,0.132841586,A,grey
119,200612_021_9,3,G,2645,3127,482,0.102650316,A,grey
120,200612_021_9,4,E,1400,3005,1605,0.144918094,A,grey
121,200612_021_9,5,G,2725,3206,481,0.096612063,A,grey
122,200612_021_9,6,H,1603,2244,641,0.043006531,A,grey
123,200612_021_9,7,E,1443,2926,1483,0.141361613,A,grey
124,200613_023_2,1,A,1763,1965,202,0.049622921,B,black
125,200613_023_2,2,J,2003,2317,314,0.116613864,B,black
126,200613_023_2,3,L,2525,3243,718,0.089321258,B,black
127,200613_023_2,4,C,1602,2444,842,0.181123661,B,black
128,200613_023_2,5,D,2003,2528,525,0.096764696,B,black
129,200613_023_2,6,J,1482,2324,842,0.161274493,B,black
130,200613_023_2,7,L,2244,3151,907,0.081877819,B,black
131,200613_023_2,8,C,1595,2806,1211,0.183604807,B,black
132,200613_023_2,9,D,1723,2684,961,0.084358966,B,black
133,200613_023_2,10,J,1402,2322,920,0.121576156,B,black
134,200613_023_2,11,L,2326,3485,1159,0.079396673,B,black
135,200613_023_4,1,A,2084,2540,456,0.017368022,B,black
136,200613_023_4,2,D,1923,2284,361,0.054585213,B,black
137,200613_023_4,3,J,1442,2324,882,0.11909501,B,black
138,200613_023_4,4,L,2043,3487,1444,0.059547505,B,black
139,200613_023_4,5,C,1603,2605,1002,0.173680223,B,black
140,200613_023_4,6,D,1843,2445,602,0.077505441,B,black
141,200613_023_4,7,J,1403,2284,881,0.121576156,B,black
142,200613_023_4,8,L,2085,3326,1241,0.086840112,B,black
143,200613_023_4,9,C,1562,2686,1124,0.171199077,B,black
144,200613_023_4,10,D,2043,2445,402,0.086840112,B,black
145,200613_023_4,11,J,1482,2284,802,0.126538448,B,black
146,200613_023_4,12,L,2124,3441,1317,0.084358966,B,black
147,200613_023_4,13,H,1445,2205,760,0.091802404,B,black
148,200613_023_4,14,K,2565,3206,641,0.061148529,B,black
149,200613_023_4,15,D,1723,2246,523,0.076987737,B,black
150,200613_024_2,1,B,2363,3020,657,0.107516329,B,black
151,200613_024_2,2,C,1739,2791,1052,0.138944179,B,black
152,200613_024_2,3,G,3123,3503,380,0.074434381,B,black
153,200613_024_2,4,A,1841,2169,328,0.038044239,B,black
154,200613_024_2,5,B,2031,2932,901,0.112478621,B,black
155,200613_024_2,6,C,1699,2788,1089,0.133981886,B,black
156,200613_024_2,7,G,3170,3455,285,0.074434381,B,black
157,200613_024_2,8,I,2363,3360,997,0.15052286,B,black
158,200613_024_3,1,B,2364,3035,671,0.115786815,B,black
159,200613_024_3,2,C,1716,2764,1048,0.130673692,B,black
160,200613_024_3,3,G,3166,3401,235,0.081050771,B,black
161,200613_024_3,4,A,1803,2124,321,0.038044239,B,black
162,200613_024_3,5,B,1963,3166,1203,0.104208134,B,black
163,200613_024_3,6,C,1603,2722,1119,0.145560568,B,black
164,200613_024_3,7,G,3206,3404,198,0.072780284,B,black
165,200613_025_2,1,A,2003,2281,278,0.03142785,B,black
166,200613_025_2,2,H,1763,2164,401,0.05623931,B,black
167,200613_025_2,3,I,1723,3286,1563,0.140598276,B,black
168,200613_025_2,4,D,1442,2245,803,0.08766716,B,black
169,200613_025_4,1,A,2084,2284,200,0.029773753,B,black
170,200613_025_4,2,H,1681,2202,521,0.059547505,B,black
171,200613_025_4,3,A,1640,2319,679,0.043006531,B,black
172,200613_025_4,4,H,1766,3367,1601,0.054585213,B,black
173,200613_025_4,5,I,2002,3327,1325,0.142252373,B,black
174,200613_025_4,6,D,1481,2285,804,0.095937647,B,black
175,200613_025_4,7,I,2003,3326,1323,0.138944179,B,black
176,200613_025_4,8,A,1679,2326,647,0.043006531,B,black
177,200613_025_4,9,C,1405,3084,1679,0.172026126,B,black
178,200613_026_6,1,D,1882,2967,1085,0.110824523,B,black
179,200613_026_6,2,C,1681,2687,1006,0.152176957,B,black
180,200613_026_6,3,G,3126,3359,233,0.081050771,B,black
181,200613_026_6,4,A,1723,2242,519,0.05623931,B,black
182,200613_026_6,5,D,1645,3082,1437,0.11909501,B,black
183,200613_026_6,6,C,1682,2648,966,0.138944179,B,black
184,200613_026_6,7,G,3166,3407,241,0.089321258,B,black
185,200613_026_7,1,A,1679,2180,501,0.044660629,B,black
186,200613_026_7,2,D,1720,2885,1165,0.112478621,B,black
187,200613_026_7,3,C,1683,2766,1083,0.138944179,B,black
188,200613_026_7,4,G,3166,3447,281,0.086013063,B,black
189,200613_026_7,5,A,1562,2324,762,0.052931116,B,black
190,200613_026_7,6,D,1765,2965,1200,0.105862231,B,black
191,200613_026_7,7,C,1638,2724,1086,0.130673692,B,black
192,200613_026_7,8,G,3086,3325,239,0.084358966,B,black
193,200613_027_5,1,A,2045,2284,239,0.02481146,B,black
194,200613_027_5,2,H,1764,2163,399,0.067817992,B,black
195,200613_027_5,3,I,1763,3366,1603,0.143906471,B,black
196,200613_027_5,4,D,1642,2246,604,0.104208134,B,black
197,200613_027_5,5,I,1725,3327,1602,0.143906471,B,black
198,200613_027_6,1,H,1685,2086,401,0.067817992,B,black
199,200613_027_6,2,A,1720,2325,605,0.036390142,B,black
200,200613_027_6,3,H,1768,2084,316,0.0628557,B,black
201,200613_027_6,4,I,1963,3286,1323,0.145560568,B,black
202,200613_027_6,5,D,1482,2283,801,0.099245842,B,black
203,200613_027_6,6,I,1962,3326,1364,0.145560568,B,black
204,200613_027_6,7,A,1643,2284,641,0.041352434,B,black
205,200613_027_6,8,C,1441,2965,1524,0.186913002,B,black
206,200613_029_1,1,A,2244,2845,601,0.034736045,B,black
207,200613_029_1,2,I,2164,3126,962,0.127365497,B,black
208,200613_029_1,3,F,1923,2724,801,0.081050771,B,black
209,200613_029_1,4,I,2001,3243,1242,0.130673692,B,black
210,200613_029_3,1,A,2525,2701,176,0.033081947,B,black
211,200613_029_3,2,I,2083,3206,1123,0.122403205,B,black
212,200613_029_3,3,F,1602,2726,1124,0.086013063,B,black
213,200613_029_3,4,I,1883,3206,1323,0.132327789,B,black
214,200613_030_2,1,A,2084,2170,86,0.021503266,B,black
215,200613_030_2,2,H,2084,2181,97,0.049622921,B,black
216,200613_030_2,3,I,2075,3087,1012,0.140598276,B,black
217,200613_030_2,4,H,2044,2236,192,0.061201602,B,black
218,200613_030_2,5,I,1842,3165,1323,0.133981886,B,black
219,200613_030_2,6,A,2124,2404,280,0.02481146,B,black
220,200613_030_2,7,A,1445,1643,198,0.021503266,B,black
221,200613_030_2,8,E,1522,2646,1124,0.117440913,B,black
222,200613_030_3,1,A,1923,2124,201,0.051277018,B,black
223,200613_030_3,2,I,1963,3126,1163,0.142252373,B,black
224,200613_030_3,3,H,1964,2086,122,0.064509797,B,black
225,200613_030_3,4,I,1961,3204,1243,0.143906471,B,black
226,200613_030_3,5,A,1882,2241,359,0.026465558,B,black
227,200613_030_3,6,E,1442,2647,1205,0.102554037,B,black
228,200613_033_9,1,A,1961,2525,564,0.038044239,B,black
229,200613_033_9,2,H,1766,2123,357,0.051277018,B,black
230,200613_033_9,3,I,1800,3130,1330,0.143906471,B,black
231,200613_033_10,1,A,1922,2525,603,0.028119655,B,black
232,200613_033_10,2,H,1804,2202,398,0.043006531,B,black
233,200613_033_10,3,I,1843,3085,1242,0.148868763,B,black
234,200613_034_2,1,D,1644,2364,720,0.104208134,B,black
235,200613_034_2,2,I,1605,3327,1722,0.15713925,B,black
236,200613_034_2,3,D,1566,2485,919,0.117440913,B,black
237,200613_034_2,4,I,1723,3366,1643,0.147214665,B,black
238,200613_034_2,5,A,1562,2104,542,0.043006531,B,black
239,200613_034_2,6,C,1322,2925,1603,0.195183489,B,black
240,200613_034_3,1,A,1723,2765,1042,0.034736045,B,black
241,200613_034_3,2,H,1759,2244,485,0.05623931,B,black
242,200613_034_3,3,I,1721,3205,1484,0.147214665,B,black
243,200613_034_3,4,D,1640,2365,725,0.099245842,B,black
244,200613_034_3,5,I,1722,3246,1524,0.145560568,B,black
245,200613_034_3,6,A,1563,2206,643,0.044660629,B,black
246,200613_034_3,7,C,1401,2805,1404,0.193529392,B,black
247,200613_042_4,1,H,2766,2968,202,0.066163895,B,black
248,200613_042_4,2,J,1926,2724,798,0.076088479,B,black
249,200613_042_4,3,A,2885,3077,192,0.064509797,B,black
250,200613_042_4,4,L,1680,3002,1322,0.104208134,B,black
251,200613_042_4,5,A,2886,3028,142,0.033081947,B,black
252,200613_042_4,6,D,1482,2123,641,0.084358966,B,black
253,200613_042_4,7,I,1562,3204,1642,0.178642515,B,black
254,200613_042_4,8,L,1405,3088,1683,0.117440913,B,black
255,200613_042_4,9,I,1522,3244,1722,0.167063834,B,black
256,200613_042_5,1,A,2601,2799,198,0.023157363,B,black
257,200613_042_5,2,L,1522,3004,1482,0.102554037,B,black
258,200613_042_5,3,D,1603,2196,593,0.064509797,B,black
259,200613_042_5,4,I,1523,3166,1643,0.162101542,B,black
260,200613_042_5,5,L,1561,3005,1444,0.110824523,B,black
261,200613_042_5,6,I,1522,3290,1768,0.160447444,B,black
262,200613_001_2,1,D,2003,2765,762,0.067817992,C,grey
263,200613_001_2,2,G,3006,3251,245,0.105862231,C,grey
264,200613_001_2,3,C,1526,2963,1437,0.170372028,C,grey
265,200613_001_2,4,D,1763,3118,1355,0.074434381,C,grey
266,200613_001_2,5,G,3002,3206,204,0.100899939,C,grey
267,200613_001_2,6,C,1643,2688,1045,0.173680223,C,grey
268,200613_001_2,7,D,1723,2765,1042,0.076088479,C,grey
269,200613_001_3,1,D,1843,2564,721,0.071126187,C,grey
270,200613_001_3,2,E,1677,2603,926,0.11909501,C,grey
271,200613_001_3,3,A,1763,2605,842,0.043006531,C,grey
272,200613_001_3,4,G,1845,3487,1642,0.097591744,C,grey
273,200613_001_3,5,E,1521,2447,926,0.114132718,C,grey
274,200613_001_3,6,A,1683,2485,802,0.046314726,C,grey
275,200613_001_3,7,G,2765,3326,561,0.102554037,C,grey
276,200613_001_3,8,E,1522,2324,802,0.117440913,C,grey
277,200613_001_3,9,A,1683,2366,683,0.041352434,C,grey
278,200613_001_3,10,G,2565,3283,718,0.092629452,C,grey
279,200613_001_11,1,A,2725,2930,205,0.038044239,C,grey
280,200613_001_11,2,G,3087,3406,319,0.095937647,C,grey
281,200613_001_11,3,A,1402,2041,639,0.02481146,C,grey
282,200613_001_11,4,X,1482,2929,1447,0.120749108,C,grey
283,200613_001_11,5,D,1803,2885,1082,0.071126187,C,grey
284,200613_001_11,6,G,3006,3246,240,0.100899939,C,grey
285,200613_001_11,7,A,1401,2002,601,0.02481146,C,grey
286,200613_001_11,8,X,1562,2884,1322,0.107516329,C,grey
287,200613_001_11,9,D,1844,3005,1161,0.0628557,C,grey
288,200613_002_1,1,A,1722,2489,767,0.039698337,C,grey
289,200613_002_1,2,D,1883,2525,642,0.076915527,C,grey
290,200613_002_1,3,E,1482,2365,883,0.114132718,C,grey
291,200613_002_1,4,A,1641,2484,843,0.039698337,C,grey
292,200613_002_1,5,G,2605,3166,561,0.089321258,C,grey
293,200613_002_1,6,E,1484,2326,842,0.111651572,C,grey
294,200613_002_1,7,A,1603,2443,840,0.042179483,C,grey
295,200613_002_1,8,G,2565,3126,561,0.099245842,C,grey
296,200613_002_1,9,E,1562,2284,722,0.109170426,C,grey
297,200613_005_2,1,A,1603,2442,839,0.039698337,C,grey
298,200613_005_2,2,D,1843,2605,762,0.091802404,C,grey
299,200613_005_2,3,E,1644,2445,801,0.133981886,C,grey
300,200613_005_2,4,A,1842,2451,609,0.049622921,C,grey
301,200613_005_2,5,G,2725,3406,681,0.104208134,C,grey
302,200613_005_2,6,E,1522,2498,976,0.124057302,C,grey
303,200613_005_2,7,A,1482,2439,957,0.057066359,C,grey
304,200613_005_2,8,G,2760,3366,606,0.10668928,C,grey
305,200613_005_2,9,A,1483,2595,1112,0.049622921,C,grey
306,200613_005_2,10,E,1482,2484,1002,0.166236785,C,grey
307,200613_005_2,11,B,1923,3207,1284,0.121576156,C,grey
308,200613_005_3,1,A,2003,2489,486,0.044660629,C,grey
309,200613_005_3,2,D,1801,2525,724,0.099245842,C,grey
310,200613_005_3,3,E,1603,2364,761,0.126538448,C,grey
311,200613_005_3,4,A,1957,2488,531,0.054585213,C,grey
312,200613_005_3,5,G,2685,3286,601,0.111651572,C,grey
313,200613_005_3,6,E,1604,2601,997,0.13150074,C,grey
314,200613_005_3,7,A,1600,2565,965,0.052104067,C,grey
315,200613_005_3,8,G,2805,3326,521,0.101726988,C,grey
316,200613_005_3,9,A,1562,2604,1042,0.057066359,C,grey
317,200613_005_3,10,E,1322,2566,1244,0.156312201,C,grey
318,200613_005_3,11,B,2084,3167,1083,0.116613864,C,grey
319,200613_005_6,1,A,1883,2519,636,0.034736045,C,grey
320,200613_005_6,2,A,1562,2484,922,0.044660629,C,grey
321,200613_005_6,3,D,1803,2640,837,0.084358966,C,grey
322,200613_005_6,4,E,1521,2526,1005,0.124057302,C,grey
323,200613_005_6,5,A,1522,2567,1045,0.044660629,C,grey
324,200613_005_6,6,G,2765,3406,641,0.09428355,C,grey
325,200613_005_6,7,E,1402,2283,881,0.116613864,C,grey
326,200613_005_6,8,A,1763,2485,722,0.039698337,C,grey
327,200613_005_6,9,G,2688,3286,598,0.09428355,C,grey
328,200613_005_6,10,A,1642,2483,841,0.042179483,C,grey
329,200613_005_6,11,E,1322,2488,1166,0.153831055,C,grey
330,200613_005_6,12,B,1763,3169,1406,0.104208134,C,grey
331,200613_006_1,1,D,2084,2845,761,0.0628557,C,grey
332,200613_006_1,2,Y,1682,2886,1204,0.120749108,C,grey
333,200613_006_1,3,C,1523,2483,960,0.170372028,C,grey
334,200613_006_1,4,D,1963,3247,1284,0.066163895,C,grey
335,200613_006_1,5,Y,1925,3008,1083,0.107516329,C,grey
336,200613_006_1,6,C,1450,2564,1114,0.170372028,C,grey
337,200613_006_1,7,D,2401,3243,842,0.067817992,C,grey
338,200613_006_1,8,Y,1682,2969,1287,0.107516329,C,grey
339,200613_006_2,1,D,2084,3006,922,0.061201602,C,grey
340,200613_006_2,2,Y,1841,2967,1126,0.117440913,C,grey
341,200613_006_2,3,C,1560,2605,1045,0.167063834,C,grey
342,200613_006_2,4,D,2364,3322,958,0.076088479,C,grey
343,200613_006_2,5,Y,1601,3005,1404,0.110824523,C,grey
344,200613_006_2,6,C,1592,2639,1047,0.170372028,C,grey
345,200613_006_2,7,D,2204,3123,919,0.064509797,C,grey
346,200613_006_2,8,Y,1682,3086,1404,0.110824523,C,grey
347,200613_007_1,1,A,2685,3259,574,0.039698337,C,grey
348,200613_007_1,2,J,1402,2204,802,0.107516329,C,grey
349,200613_007_1,3,Z,1522,3647,2125,0.188567099,C,grey
350,200613_007_2,1,A,2685,3246,561,0.028119655,C,grey
351,200613_007_2,2,J,1521,2205,684,0.107516329,C,grey
352,200613_007_2,3,Z,1643,3449,1806,0.211724463,C,grey
353,200613_008_2,1,H,1763,2082,319,0.066163895,C,grey
354,200613_008_2,2,K,2725,3410,685,0.069472089,C,grey
355,200613_008_2,3,H,1844,2246,402,0.0628557,C,grey
356,200613_008_2,4,K,2563,3285,722,0.071126187,C,grey
357,200613_008_3,1,H,1564,1923,359,0.057893408,C,grey
358,200613_008_3,2,K,2649,3168,519,0.071126187,C,grey
359,200613_008_3,3,H,1566,1843,277,0.054585213,C,grey
360,200613_012_2,1,E,1440,2086,646,0.08766716,C,grey
361,200613_012_2,2,Z,1442,3129,1687,0.183604807,C,grey
362,200613_012_2,3,A,1723,2768,1045,0.039698337,C,grey
363,200613_012_2,4,E,1402,2247,845,0.086013063,C,grey
364,200613_012_2,5,Z,1562,3248,1686,0.170372028,C,grey
365,200613_012_2,6,A,1763,2965,1202,0.044660629,C,grey
366,200613_012_2,7,D,1401,2366,965,0.046314726,C,grey
367,200613_012_2,8,B,2285,3124,839,0.086013063,C,grey
368,200613_012_2,9,C,1323,3845,2522,0.133981886,C,grey
369,200613_012_4,1,A,1644,2595,951,0.029773753,C,grey
370,200613_012_4,2,E,1482,2164,682,0.089321258,C,grey
371,200613_012_4,3,Z,1522,3407,1885,0.18195071,C,grey
372,200613_012_4,4,A,1843,2765,922,0.039698337,C,grey
373,200613_012_4,5,E,1478,2283,805,0.086013063,C,grey
374,200613_012_4,6,Z,1603,3445,1842,0.165409736,C,grey
375,200613_012_4,7,A,1721,2726,1005,0.038044239,C,grey
376,200613_012_4,8,D,1442,2244,802,0.043006531,C,grey
377,200613_012_4,9,B,2324,3088,764,0.081050771,C,grey
378,200613_012_4,10,C,1242,2763,1521,0.112478621,C,grey
379,200613_015_1,1,B,2126,2925,799,0.097591744,C,grey
380,200613_015_1,2,D,1522,2043,521,0.084358966,C,grey
381,200613_015_1,3,A,1763,2605,842,0.041352434,C,grey
382,200613_015_1,4,C,1482,2888,1406,0.133981886,C,grey
383,200613_015_1,5,G,2685,3487,802,0.104208134,C,grey
384,200613_015_1,6,D,1484,2081,597,0.072780284,C,grey
385,200613_015_1,7,A,2164,2606,442,0.047968824,C,grey
386,200613_015_1,8,C,1483,3006,1523,0.129019594,C,grey
387,200613_015_4,1,B,2449,3286,837,0.097591744,C,grey
388,200613_015_4,2,E,1801,2963,1162,0.148868763,C,grey
389,200613_015_4,3,A,2364,2605,241,0.044660629,C,grey
390,200613_015_4,4,B,2126,2925,799,0.099245842,C,grey
391,200613_015_4,5,D,1442,1963,521,0.086013063,C,grey
392,200613_015_4,6,A,2404,2631,227,0.051277018,C,grey
393,200613_015_4,7,C,1558,3007,1449,0.115786815,C,grey
394,200613_016_2,1,A,2009,2643,634,0.029773753,C,grey
395,200613_016_2,2,B,2605,3324,719,0.086013063,C,grey
396,200613_016_2,3,E,1803,2685,882,0.143906471,C,grey
397,200613_016_2,4,A,1723,2567,844,0.051277018,C,grey
398,200613_016_2,5,B,2324,3165,841,0.089321258,C,grey
399,200613_016_2,6,H,1681,2003,322,0.082704868,C,grey
400,200613_016_2,7,A,2164,2605,441,0.043006531,C,grey
401,200613_016_2,8,C,1642,2966,1324,0.114132718,C,grey
402,200613_016_5,1,A,2043,2767,724,0.029773753,C,grey
403,200613_016_5,2,B,2568,3286,718,0.089321258,C,grey
404,200613_016_5,3,E,1843,2719,876,0.142252373,C,grey
405,200613_016_5,4,A,2283,2720,437,0.047968824,C,grey
406,200613_016_5,5,B,2244,3125,881,0.09428355,C,grey
407,200613_016_5,6,H,1562,1961,399,0.08766716,C,grey
408,200613_016_5,7,A,2084,2447,363,0.036390142,C,grey
409,200613_016_5,8,C,1484,2965,1481,0.135635984,C,grey
410,200613_016_14,1,A,2299,2528,229,0.029773753,C,grey
411,200613_016_14,2,B,2526,3286,760,0.095937647,C,grey
412,200613_016_14,3,E,1885,2563,678,0.15052286,C,grey
413,200613_016_14,4,A,2085,2524,439,0.049622921,C,grey
414,200613_016_14,5,B,2324,3087,763,0.100899939,C,grey
415,200613_016_14,6,H,1601,2043,442,0.079396673,C,grey
416,200613_016_14,7,A,2202,2482,280,0.038044239,C,grey
417,200613_016_14,8,C,1645,2926,1281,0.132327789,C,grey
418,200704_022_4,1,A,2446,2685,239,0.032254899,D,white
419,200704_022_4,2,B,3086,4008,922,0.091802404,D,white
420,200704_022_4,3,E,1402,2965,1563,0.186085953,D,white
421,200704_022_4,4,A,2325,2531,206,0.032254899,D,white
422,200704_022_4,5,B,3127,3888,761,0.099245842,D,white
423,200704_022_4,6,E,1522,2889,1367,0.196010538,D,white
424,200704_022_4,7,b,3285,3477,192,0.081877819,D,white
425,200704_022_4,8,a,1404,2683,1279,0.205935122,D,white
426,200704_022_6,1,A,2485,2644,159,0.032254899,D,white
427,200704_022_6,2,A,2476,2531,55,0.027292606,D,white
428,200704_022_6,3,B,3042,3887,845,0.096764696,D,white
429,200704_022_6,4,E,1324,2766,1442,0.171199077,D,white
430,200704_022_6,5,A,2649,2805,156,0.02481146,D,white
431,200704_022_6,6,B,3246,3727,481,0.109170426,D,white
432,200704_022_6,7,E,1561,2806,1245,0.183604807,D,white
433,200704_023_1,1,A,2485,2724,239,0.034736045,D,white
434,200704_023_1,2,B,3163,3488,325,0.081050771,D,white
435,200704_023_1,3,E,1601,2805,1204,0.173680223,D,white
436,200704_023_2,1,B,2969,3968,999,0.102554037,D,white
437,200704_023_2,2,E,1442,2763,1321,0.172026126,D,white
438,200704_024_6,1,A,2445,2606,161,0.044660629,D,white
439,200704_024_6,2,B,3087,3738,651,0.105862231,D,white
440,200704_024_6,3,E,1521,2804,1283,0.203453976,D,white
441,200704_024_6,4,B,2526,3289,763,0.097591744,D,white
442,200704_024_6,5,a,1361,2645,1284,0.228265436,D,white
443,200704_024_6,6,A,2530,2646,116,0.02481146,D,white
444,200704_024_6,7,B,3006,3767,761,0.122403205,D,white
445,200704_024_13,1,A,2364,2565,201,0.027292606,D,white
446,200704_024_13,2,@,2245,2523,278,0.091802404,D,white
447,200704_024_13,3,A,2404,2641,237,0.037217191,D,white
448,200704_024_13,4,A,2480,2645,165,0.029773753,D,white
449,200704_024_13,5,B,3047,2928,-119,0.109170426,D,white
450,200704_024_13,6,E,1562,2804,1242,0.178642515,D,white
451,200704_024_13,7,b,2525,3249,724,0.064509797,D,white
452,200704_024_13,8,a,1441,2526,1085,0.205935122,D,white
453,200704_028_2,1,A,2404,2566,162,0.02481146,D,white
454,200704_028_2,2,A,2325,2563,238,0.023157363,D,white
455,200704_028_2,3,B,3128,4206,1078,0.095937647,D,white
456,200704_028_2,4,E,1523,2765,1242,0.162101542,D,white
457,200704_028_3,1,A,2484,2592,108,0.021503266,D,white
458,200704_028_3,2,B,3245,4127,882,0.082704868,D,white
459,200704_028_3,3,E,1402,2845,1443,0.163755639,D,white
460,200704_030_13,1,A,2443,2645,202,0.023157363,D,white
461,200704_030_13,2,A,2404,2681,277,0.023157363,D,white
462,200704_030_13,3,B,3127,3846,719,0.095937647,D,white
463,200704_030_13,4,E,1445,2722,1277,0.172026126,D,white
464,200704_030_13,5,b,2719,3366,647,0.105862231,D,white
465,200704_030_13,6,a,1322,2525,1203,0.203453976,D,white
466,200704_030_14,1,A,2484,2726,242,0.014886876,D,white
467,200704_030_14,2,A,2477,2645,168,0.018195071,D,white
468,200704_030_14,3,B,3084,3768,684,0.112478621,D,white
469,200704_030_14,4,E,1522,2729,1207,0.172026126,D,white
470,200704_030_14,5,b,2605,3166,561,0.092629452,D,white
471,200704_030_14,6,a,1403,2567,1164,0.210070365,D,white
472,200704_033_1,1,A,2485,2724,239,0.029773753,D,white
473,200704_033_1,2,A,2484,2812,328,0.029773753,D,white
474,200704_033_1,3,B,3127,3846,719,0.081877819,D,white
475,200704_033_1,4,E,1603,2965,1362,0.171199077,D,white
476,200704_033_1,5,b,2725,3406,681,0.064509797,D,white
477,200704_033_1,6,a,1443,2642,1199,0.208416268,D,white
478,200704_033_2,1,A,2565,2765,200,0.02481146,D,white
479,200704_033_2,2,B,3046,3849,803,0.086840112,D,white
480,200704_033_2,3,E,1603,2962,1359,0.168717931,D,white
481,200704_033_2,4,b,2645,3326,681,0.066990943,D,white
482,200704_033_2,5,a,1402,2845,1443,0.205935122,D,white
483,200704_033_2,6,A,2364,2765,401,0.027292606,D,white
484,200704_033_2,7,B,3168,3926,758,0.074434381,D,white
485,200704_033_2,8,E,1522,2844,1322,0.161274493,D,white
486,200704_034_8,1,A,2484,2645,161,0.021503266,D,white
487,200704_034_8,2,A,2327,2640,313,0.029773753,D,white
488,200704_034_8,3,B,3088,3807,719,0.095937647,D,white
489,200704_034_8,4,E,1482,2845,1363,0.172026126,D,white
490,200704_034_8,5,b,2681,3365,684,0.059547505,D,white
491,200704_034_8,6,a,1522,2527,1005,0.208416268,D,white
492,200704_034_9,1,A,2644,2766,122,0.016540974,D,white
493,200704_034_9,2,A,2519,2730,211,0.026465558,D,white
494,200704_034_9,3,B,3166,3805,639,0.09428355,D,white
495,200704_034_9,4,E,1481,2806,1325,0.165409736,D,white
496,200704_034_9,5,b,2802,3286,484,0.066163895,D,white
497,200704_034_9,6,a,1483,2565,1082,0.186913002,D,white
498,200704_039_1,1,A,2484,2726,242,0.029773753,D,white
499,200704_039_1,2,B,3085,3849,764,0.09428355,D,white
500,200704_039_1,3,E,1364,2765,1401,0.168717931,D,white
501,200704_039_2,1,A,2524,2728,204,0.03142785,D,white
502,200704_039_2,2,A,2484,2645,161,0.033081947,D,white
503,200704_039_2,3,B,3049,3770,721,0.089321258,D,white
504,200704_039_2,4,E,1441,2803,1362,0.165409736,D,white
505,200704_040_1,1,A,2362,2686,324,0.028119655,D,white
506,200704_040_1,2,A,2404,2685,281,0.028119655,D,white
507,200704_040_1,3,B,3084,4529,1445,0.142252373,D,white
508,200704_040_1,4,E,1526,3042,1516,0.176988418,D,white
509,200704_040_2,1,A,2471,2646,175,0.026465558,D,white
510,200704_040_2,2,A,2364,2640,276,0.033081947,D,white
511,200704_040_2,3,B,3246,4439,1193,0.105862231,D,white
512,200704_040_2,4,E,1362,2685,1323,0.162101542,D,white
513,200704_041_5,1,A,2470,2646,176,0.028119655,D,white
514,200704_041_5,2,A,2485,2644,159,0.03142785,D,white
515,200704_041_5,3,B,3084,3806,722,0.09428355,D,white
516,200704_041_5,4,E,1323,2765,1442,0.170372028,D,white
517,200704_041_5,5,b,2765,3246,481,0.067817992,D,white
518,200704_041_5,6,a,1362,2443,1081,0.210070365,D,white
519,200704_041_7,1,A,2442,2721,279,0.026465558,D,white
520,200704_041_7,2,B,3046,3768,722,0.090975355,D,white
521,200704_041_7,3,E,1404,2925,1521,0.180296613,D,white
522,200704_041_7,4,b,2526,3125,599,0.072780284,D,white
523,200704_041_7,5,a,1282,2424,1142,0.190221197,D,white
524,200704_003_1,1,A,2765,2925,160,0.038044239,E,white
525,200704_003_1,2,P,1883,3086,1203,0.135635984,E,white
526,200704_003_1,3,E,1522,2403,881,0.132327789,E,white
527,200704_003_1,4,A,1924,2243,319,0.028119655,E,white
528,200704_003_1,5,B,1721,2460,739,0.097591744,E,white
529,200704_003_1,6,E,1443,2287,844,0.127365497,E,white
530,200704_003_1,7,A,2124,2292,168,0.026465558,E,white
531,200704_003_1,8,E,1723,2408,685,0.090975355,E,white
532,200704_003_3,1,A,2235,2585,350,0.026465558,E,white
533,200704_003_3,2,B,1847,2399,552,0.099245842,E,white
534,200704_003_3,3,E,1380,2432,1052,0.137290081,E,white
535,200704_003_3,4,A,1767,1963,196,0.028119655,E,white
536,200704_003_3,5,B,1808,2430,622,0.099245842,E,white
537,200704_003_3,6,E,1381,2314,933,0.133981886,E,white
538,200704_005_2,1,H,2357,2645,288,0.062028651,E,white
539,200704_005_2,2,B,1842,3087,1245,0.11909501,E,white
540,200704_005_2,3,E,1522,2805,1283,0.13150074,E,white
541,200704_005_2,4,H,2204,2493,289,0.059547505,E,white
542,200704_005_2,5,B,1723,3086,1363,0.114132718,E,white
543,200704_005_2,6,E,1522,2885,1363,0.13150074,E,white
544,200704_005_2,7,H,2204,2525,321,0.059547505,E,white
545,200704_005_2,8,B,1723,3166,1443,0.111651572,E,white
546,200704_005_2,9,E,1482,2605,1123,0.141425325,E,white
547,200704_005_4,1,H,2204,2493,289,0.072780284,E,white
548,200704_005_4,2,B,1765,3244,1479,0.112478621,E,white
549,200704_005_4,3,E,1643,2605,962,0.155485152,E,white
550,200704_005_4,4,H,2165,2604,439,0.079396673,E,white
551,200704_005_4,5,B,1686,3085,1399,0.11909501,E,white
552,200704_005_4,6,E,1643,2647,1004,0.145560568,E,white
553,200704_005_4,7,H,2122,2525,403,0.079396673,E,white
554,200704_005_4,8,B,1723,3046,1323,0.1257114,E,white
555,200704_005_4,9,E,1482,2645,1163,0.162101542,E,white
556,200704_005_4,10,K,2805,3286,481,0.059547505,E,white
557,200704_005_4,11,H,1723,2565,842,0.072780284,E,white
558,200704_005_4,12,K,2685,2885,200,0.092629452,E,white
559,200704_005_4,13,A,1763,2242,479,0.036390142,E,white
560,200704_005_4,14,B,1643,2644,1001,0.109170426,E,white
561,200704_007_3,2,E,1404,2402,998,0.090975355,E,white
562,200704_007_3,3,B,2204,2885,681,0.107516329,E,white
563,200704_007_3,4,A,2084,3046,962,0.029773753,E,white
564,200704_007_3,5,E,1563,2205,642,0.082704868,E,white
565,200704_007_3,6,B,2283,2927,644,0.1257114,E,white
566,200704_007_3,7,A,1721,1804,83,0.029773753,E,white
567,200704_007_3,8,E,1359,2402,1043,0.02481146,E,white
568,200704_007_3,9,B,2324,3126,802,0.081050771,E,white
569,200704_007_4,1,A,2605,2806,201,0.036390142,E,white
570,200704_007_4,2,E,1362,2885,1523,0.076088479,E,white
571,200704_007_4,3,B,2444,3206,762,0.069472089,E,white
572,200704_007_4,4,F,1562,2768,1206,0.124057302,E,white
573,200704_007_4,5,A,2403,2647,244,0.029773753,E,white
574,200704_007_4,6,E,1402,2725,1323,0.074434381,E,white
575,200704_007_4,7,B,2645,3086,441,0.076088479,E,white
576,200704_007_4,8,A,1362,1884,522,0.02481146,E,white
577,200704_007_4,9,E,1121,1843,722,0.066163895,E,white
578,200704_007_4,10,B,2204,2845,641,0.067817992,E,white
579,200704_008_1,1,H,2402,2563,161,0.064509797,E,white
580,200704_008_1,2,B,1643,3286,1643,0.115786815,E,white
581,200704_008_1,3,E,1685,2769,1084,0.130673692,E,white
582,200704_008_1,4,H,2360,2607,247,0.049622921,E,white
583,200704_008_1,5,B,1643,3406,1763,0.117440913,E,white
584,200704_008_2,1,H,2205,2643,438,0.047968824,E,white
585,200704_008_2,2,B,1641,3326,1685,0.135635984,E,white
586,200704_008_2,3,E,1602,2927,1325,0.11909501,E,white
587,200704_008_2,4,H,2284,2609,325,0.0628557,E,white
588,200704_008_2,5,B,1562,3486,1924,0.109170426,E,white
589,200704_009_8,1,A,2565,2804,239,0.054585213,E,white
590,200704_009_8,2,D,1522,2363,841,0.051277018,E,white
591,200704_009_8,3,K,2565,3007,442,0.051277018,E,white
592,200704_009_8,4,A,2646,2687,41,0.067817992,E,white
593,200704_009_8,5,D,1482,2404,922,0.059547505,E,white
594,200704_009_8,6,K,2885,3002,117,0.057893408,E,white
595,200704_009_8,7,C,1363,2925,1562,0.228265436,E,white
596,200704_009_8,8,K,2364,2841,477,0.061201602,E,white
597,200704_009_9,1,A,2685,2923,238,0.044660629,E,white
598,200704_009_9,2,L,2442,2568,126,0.049622921,E,white
599,200704_009_9,3,K,3166,3529,363,0.061201602,E,white
600,200704_009_9,4,A,2766,3128,362,0.064509797,E,white
601,200704_009_9,5,L,1362,2446,1084,0.046314726,E,white
602,200704_009_9,6,K,3006,3247,241,0.05623931,E,white
603,200704_009_9,7,C,1603,2805,1202,0.234881826,E,white
604,200704_009_9,8,K,2524,2926,402,0.059547505,E,white
605,200704_010_1,1,A,2365,2524,159,0.071953235,E,white
606,200704_010_1,2,B,1443,3366,1923,0.11909501,E,white
607,200704_010_1,3,E,1483,2725,1242,0.136463032,E,white
608,200704_010_1,4,A,2164,2605,441,0.066990943,E,white
609,200704_010_1,5,B,1481,3206,1725,0.124057302,E,white
610,200704_010_1,6,E,1557,2849,1292,0.136463032,E,white
611,200704_010_1,7,A,2204,2560,356,0.071953235,E,white
612,200704_010_1,8,B,1404,3283,1879,0.121576156,E,white
613,200704_012_2,1,@,2389,2465,76,0.100899939,E,white
614,200704_012_2,2,E,1404,2405,1001,0.120749108,E,white
615,200704_012_2,3,A,1763,2164,401,0.041352434,E,white
616,200704_012_2,4,@,2283,2476,193,0.112478621,E,white
617,200704_012_3,1,B,1557,2565,1008,0.115786815,E,white
618,200704_012_3,2,E,1442,2284,842,0.138944179,E,white
619,200704_012_3,3,A,1883,1963,80,0.061201602,E,white
620,200704_012_3,4,B,1362,2528,1166,0.127365497,E,white
621,200704_013_1,1,A,1764,2482,718,0.034736045,E,white
622,200704_013_1,2,A,2044,2285,241,0.041352434,E,white
623,200704_013_1,3,B,2003,3086,1083,0.084358966,E,white
624,200704_013_1,4,E,1603,2404,801,0.152176957,E,white
625,200704_015_1,1,@,2364,2605,241,0.076088479,E,white
626,200704_015_1,2,B,1843,3246,1403,0.115786815,E,white
627,200704_015_1,3,E,1600,2724,1124,0.129019594,E,white
628,200704_015_1,4,@,2284,2565,281,0.081050771,E,white
629,200704_015_1,5,B,1881,3247,1366,0.114132718,E,white
630,200704_018_1,1,A,2449,2643,194,0.029773753,E,white
631,200704_018_1,2,A,2447,2646,199,0.028119655,E,white
632,200704_018_1,3,B,3046,3807,761,0.08766716,E,white
633,200704_018_1,4,E,1883,2845,962,0.167063834,E,white
634,200704_018_1,5,A,2480,2648,168,0.05623931,E,white
635,200704_018_1,6,a,1763,2529,766,0.178642515,E,white
636,200704_018_2,1,A,2478,2605,127,0.023157363,E,white
637,200704_018_2,2,A,2404,2726,322,0.021503266,E,white
638,200704_018_2,3,B,2927,3728,801,0.102554037,E,white
639,200704_020_1,1,A,2184,2682,498,0.026465558,E,white
640,200704_020_1,2,B,2767,3608,841,0.08766716,E,white
641,200704_020_1,3,E,1686,3083,1397,0.168717931,E,white
642,200704_020_1,4,A,2204,2484,280,0.028119655,E,white
643,200704_020_1,5,B,2765,3246,481,0.092629452,E,white
644,200704_020_3,1,A,2405,2645,240,0.021503266,E,white
645,200704_020_3,2,B,2961,3366,405,0.097591744,E,white
646,200704_020_3,3,E,1682,3128,1446,0.190221197,E,white
647,200704_020_3,4,A,2205,2449,244,0.023157363,E,white
648,200704_020_3,5,B,2725,3446,721,0.099245842,E,white
649,200704_020_10,1,A,2284,2725,441,0.026465558,E,white
650,200704_020_10,2,B,2887,3525,638,0.092629452,E,white
651,200704_020_10,3,E,1683,3202,1519,0.173680223,E,white
652,200704_020_10,4,A,2084,2681,597,0.023157363,E,white
653,200704_020_10,5,B,2845,3447,602,0.090975355,E,white
654,200704_020_10,6,E,1680,3048,1368,0.186913002,E,white
655,200705_002_1,3,H,2125,2564,439,0.05623931,F,black
656,200705_002_1,4,E,1803,2525,722,0.089321258,F,black
657,200705_002_1,5,G,2805,3287,482,0.100899939,F,black
658,200705_002_1,6,A,2242,2843,601,0.029773753,F,black
659,200705_002_1,7,D,1843,2729,886,0.057893408,F,black
660,200705_002_1,8,A,2396,2415,19,0.079396673,F,black
661,200705_002_1,9,G,2726,3088,362,0.097591744,F,black
662,200705_002_6,1,A,2605,2961,356,0.02481146,F,black
663,200705_002_6,2,E,1644,2645,1001,0.117440913,F,black
664,200705_002_6,3,G,2647,3366,719,0.099245842,F,black
665,200705_002_6,4,A,2571,2758,187,0.02481146,F,black
666,200705_002_6,5,C,1602,2484,882,0.122403205,F,black
667,200705_002_6,6,G,2565,3167,602,0.097591744,F,black
668,200705_003_8,1,A,1962,2247,285,0.023157363,F,black
669,200705_003_8,2,A,2004,2403,399,0.033081947,F,black
670,200705_003_8,3,E,1524,2442,918,0.110824523,F,black
671,200705_003_8,4,G,2807,3485,678,0.092629452,F,black
672,200705_003_8,5,A,2164,2766,602,0.034736045,F,black
673,200705_003_8,6,D,1922,2840,918,0.052931116,F,black
674,200705_003_8,7,C,1562,2565,1003,0.1257114,F,black
675,200705_003_8,8,G,2568,3086,518,0.095937647,F,black
676,200705_003_9,1,A,2125,2882,757,0.026465558,F,black
677,200705_003_9,2,D,1685,2523,838,0.061201602,F,black
678,200705_003_9,3,j,2366,3204,838,0.130673692,F,black
679,200705_003_9,4,F,1563,3205,1642,0.186913002,F,black
680,200705_003_9,5,K,2685,2927,242,0.0628557,F,black
681,200705_003_9,6,D,1723,2598,875,0.059547505,F,black
682,200705_003_9,7,j,2284,3286,1002,0.138944179,F,black
683,200705_004_9,1,D,1645,2564,919,0.059547505,F,black
684,200705_004_9,2,D,1643,2324,681,0.061201602,F,black
685,200705_004_9,3,j,2404,3326,922,0.107516329,F,black
686,200705_004_9,4,F,1567,3249,1682,0.170372028,F,black
687,200705_004_9,5,K,2602,2885,283,0.051277018,F,black
688,200705_004_9,6,K,2685,2888,203,0.057893408,F,black
689,200705_004_9,7,D,1763,2244,481,0.061201602,F,black
690,200705_004_9,8,j,2125,3166,1041,0.109170426,F,black
691,200705_004_13,1,D,1562,2365,803,0.057893408,F,black
692,200705_004_13,2,D,1569,2404,835,0.061201602,F,black
693,200705_004_13,3,j,2324,3128,804,0.120749108,F,black
694,200705_004_13,4,F,1561,3125,1564,0.170372028,F,black
695,200705_004_13,5,K,2605,2887,282,0.051277018,F,black
696,200705_004_13,6,D,1442,2364,922,0.05623931,F,black
697,200705_004_13,7,j,2203,3125,922,0.107516329,F,black
698,200705_006_1,1,A,2205,2564,359,0.023157363,F,black
699,200705_006_1,2,D,1723,2525,802,0.067817992,F,black
700,200705_006_1,3,j,2323,3246,923,0.109170426,F,black
701,200705_006_1,4,F,1641,3168,1527,0.178642515,F,black
702,200705_006_1,5,K,2767,2966,199,0.051277018,F,black
703,200705_006_1,6,D,1366,2445,1079,0.069472089,F,black
704,200705_006_1,7,j,2163,3247,1084,0.109170426,F,black
705,200705_006_2,1,D,1442,2605,1163,0.061201602,F,black
706,200705_006_2,2,D,1525,2562,1037,0.064509797,F,black
707,200705_006_2,3,j,2245,3206,961,0.117440913,F,black
708,200705_006_2,4,F,1603,3247,1644,0.178642515,F,black
709,200705_006_2,5,K,2685,2968,283,0.047968824,F,black
710,200705_006_2,6,j,2164,3167,1003,0.114132718,F,black
711,200705_007_3,1,A,2401,2649,248,0.023157363,F,black
712,200705_007_3,2,E,1682,2523,841,0.117440913,F,black
713,200705_007_3,3,G,2802,3286,484,0.104208134,F,black
714,200705_007_3,4,A,2162,2325,163,0.02481146,F,black
715,200705_007_3,5,D,1963,2484,521,0.05623931,F,black
716,200705_007_3,6,C,1522,2605,1083,0.124057302,F,black
717,200705_007_3,7,G,2631,3207,576,0.099245842,F,black
718,200705_007_4,1,A,2440,2805,365,0.02481146,F,black
719,200705_007_4,2,E,1683,2439,756,0.117440913,F,black
720,200705_007_4,3,G,2645,3206,561,0.102554037,F,black
721,200705_007_4,4,A,2364,2565,201,0.023157363,F,black
722,200705_007_4,5,D,1805,2603,798,0.049622921,F,black
723,200705_007_4,6,C,1601,2565,964,0.127365497,F,black
724,200705_007_4,7,G,2562,3048,486,0.090975355,F,black
725,200705_008_2,1,A,1925,2603,678,0.032581883,F,black
726,200705_008_2,2,E,1843,2567,724,0.088162743,F,black
727,200705_008_2,3,B,2766,3325,559,0.097745649,F,black
728,200705_008_2,4,A,2164,2650,486,0.030665302,F,black
729,200705_008_2,5,k,2163,3366,1203,0.074746673,F,black
730,200705_008_2,6,D,1885,2523,638,0.097745649,F,black
731,200705_008_2,7,B,2404,3126,722,0.091995905,F,black
732,200705_008_4,1,A,1965,2723,758,0.026832139,F,black
733,200705_008_4,2,E,1561,2565,1004,0.086246161,F,black
734,200705_008_4,3,B,2606,3244,638,0.091995905,F,black
735,200705_008_4,4,A,2043,2725,682,0.036415046,F,black
736,200705_008_4,5,k,1920,3246,1326,0.07091351,F,black
737,200705_008_4,6,E,1602,2364,762,0.097745649,F,black
738,200705_008_4,7,B,2486,3203,717,0.095829068,F,black
739,200705_012_1,1,A,2325,2564,239,0.032581883,F,black
740,200705_012_1,2,D,1843,2364,521,0.065163766,F,black
741,200705_012_1,3,j,2360,3246,886,0.1130783,F,black
742,200705_012_1,4,F,1681,3167,1486,0.172492322,F,black
743,200705_012_1,5,K,2525,2886,361,0.055580859,F,black
744,200705_012_1,6,D,1884,2163,279,0.067080348,F,black
745,200705_012_1,7,j,2124,3088,964,0.120744626,F,black
746,200705_012_2,1,A,2325,2524,199,0.026832139,F,black
747,200705_012_2,2,D,1683,2565,882,0.068996929,F,black
748,200705_012_2,3,j,2204,3286,1082,0.114994882,F,black
749,200705_012_2,4,F,1603,3085,1482,0.162909416,F,black
750,200705_012_2,5,K,2525,2888,363,0.047914534,F,black
751,200705_012_2,6,D,1644,2243,599,0.063247185,F,black
752,200705_012_2,7,j,2240,2967,727,0.116911463,F,black
753,200705_017_1,1,A,2244,2725,481,0.026465558,F,black
754,200705_017_1,2,H,2400,2557,157,0.05623931,F,black
755,200705_017_1,3,E,1724,2483,759,0.11909501,F,black
756,200705_017_1,4,G,2885,3446,561,0.097591744,F,black
757,200705_017_1,5,A,2164,2725,561,0.029773753,F,black
758,200705_017_1,6,k,1885,2729,844,0.049622921,F,black
759,200705_017_1,7,C,1442,2524,1082,0.129019594,F,black
760,200705_017_1,8,G,2925,3368,443,0.107516329,F,black
761,200705_017_2,1,A,2166,3004,838,0.028119655,F,black
762,200705_017_2,2,H,2085,2484,399,0.054585213,F,black
763,200705_017_2,3,C,1763,2439,676,0.114132718,F,black
764,200705_017_2,4,G,2966,3365,399,0.09428355,F,black
765,200705_017_2,5,A,1963,2804,841,0.038044239,F,black
766,200705_017_2,6,k,1961,3003,1042,0.05623931,F,black
767,200705_017_2,7,C,1480,2447,967,0.127365497,F,black
768,200705_031_11,1,I,2565,3046,481,0.145560568,F,black
769,200705_031_11,2,G,2924,3566,642,0.082704868,F,black
770,200705_031_11,3,E,1722,3163,1441,0.155485152,F,black
771,200705_031_11,4,G,3007,3488,481,0.086013063,F,black
772,200705_031_11,5,E,1684,3125,1441,0.153831055,F,black
773,200705_031_11,6,G,2927,3565,638,0.089321258,F,black
774,200705_031_22,1,I,2164,3366,1202,0.132327789,F,black
775,200705_031_22,2,G,3321,3648,327,0.089321258,F,black
776,200705_031_22,3,E,1604,3085,1481,0.153831055,F,black
777,200705_031_22,4,G,3209,3527,318,0.097591744,F,black
778,200705_031_22,5,E,2043,3006,963,0.158793347,F,black
779,200705_031_22,6,G,3237,3528,291,0.082704868,F,black
780,200705_031_22,7,E,1682,3046,1364,0.15713925,F,black
781,200705_032_2,1,G,3367,3766,399,0.069472089,F,black
782,200705_032_2,2,E,1725,2967,1242,0.152176957,F,black
783,200705_032_2,3,G,3089,3806,717,0.081050771,F,black
784,200705_032_2,4,E,1920,3085,1165,0.155485152,F,black
785,200705_032_2,5,G,3088,3807,719,0.084358966,F,black
786,200705_032_2,6,E,1803,2965,1162,0.155485152,F,black
787,200705_032_13,1,G,3447,3846,399,0.0628557,F,black
788,200705_032_13,2,E,1562,3125,1563,0.15713925,F,black
789,200705_032_13,3,A,2925,3126,201,0.029773753,F,black
790,200705_032_13,4,G,3286,4161,875,0.072780284,F,black
791,200705_032_13,5,E,1762,3085,1323,0.15713925,F,black
792,200705_032_13,6,G,3324,3807,483,0.074434381,F,black
793,200705_032_13,7,E,1603,3084,1481,0.155485152,F,black
794,200705_039_2,1,A,2205,2564,359,0.01548742,G,grey
795,200705_039_2,2,H,1844,2123,279,0.081862077,G,grey
796,200705_039_2,3,Z,2045,3366,1321,0.157086689,G,grey
797,200705_039_2,4,H,1562,2001,439,0.086287054,G,grey
798,200705_039_2,5,Z,1603,3326,1723,0.152661711,G,grey
799,200705_039_2,6,A,2048,2685,637,0.022124886,G,grey
800,200705_039_2,7,H,1844,3262,1418,0.075224611,G,grey
801,200705_039_2,8,Z,1965,3366,1401,0.168149131,G,grey
802,200705_039_3,1,H,1843,2324,481,0.079396673,G,grey
803,200705_039_3,2,Z,1601,3287,1686,0.145560568,G,grey
804,200705_039_3,3,H,1602,2003,401,0.092629452,G,grey
805,200705_039_3,4,Z,1841,3608,1767,0.147214665,G,grey
806,200705_039_3,5,A,2806,3285,479,0.034736045,G,grey
807,200705_039_3,6,A,1522,1683,161,0.044660629,G,grey
808,200705_039_3,7,Z,1680,3326,1646,0.143906471,G,grey
809,200705_041_2,1,A,1644,2403,759,0.019849168,G,grey
810,200705_041_2,2,D,1723,2164,441,0.076088479,G,grey
811,200705_041_2,3,Z,1602,3286,1684,0.138944179,G,grey
812,200705_041_2,4,D,1482,2085,603,0.109170426,G,grey
813,200705_041_2,5,Z,1723,3648,1925,0.152176957,G,grey
814,200705_041_2,6,A,2685,3246,561,0.029773753,G,grey
815,200705_041_2,7,H,1403,1882,479,0.05623931,G,grey
816,200705_041_2,8,Z,1561,3527,1966,0.145560568,G,grey
817,200705_041_2,9,A,2284,3006,722,0.033081947,G,grey
818,200705_041_2,10,H,1322,1763,441,0.052931116,G,grey
819,200705_041_2,11,Z,1483,3567,2084,0.158793347,G,grey
820,200705_041_2,12,D,1443,1962,519,0.089321258,G,grey
821,200705_041_2,13,Z,1562,3286,1724,0.152176957,G,grey
822,200705_041_2,14,A,1643,2565,922,0.033081947,G,grey
823,200705_041_2,15,D,1484,2202,718,0.089321258,G,grey
824,200705_041_3,1,A,1923,2765,842,0.022330314,G,grey
825,200705_041_3,2,D,1803,2364,561,0.076915527,G,grey
826,200705_041_3,3,Z,1522,3326,1804,0.148868763,G,grey
827,200705_041_3,4,D,1564,2005,441,0.089321258,G,grey
828,200705_041_3,5,Z,1642,3488,1846,0.166236785,G,grey
829,200705_041_3,6,A,1803,2490,687,0.022330314,G,grey
830,200705_041_3,7,H,1564,2242,678,0.074434381,G,grey
831,200705_041_3,8,Z,1765,3366,1601,0.146387617,G,grey
832,200705_044_1,1,D,2165,2924,759,0.064509797,G,grey
833,200705_044_1,2,B,2326,3125,799,0.076915527,G,grey
834,200705_044_1,3,A,2484,3086,602,0.022330314,G,grey
835,200705_044_1,4,E,1803,2885,1082,0.091802404,G,grey
836,200705_044_1,5,K,3317,3443,126,0.059547505,G,grey
837,200705_044_1,6,E,2003,3006,1003,0.081877819,G,grey
838,200705_044_1,7,B,2244,3047,803,0.089321258,G,grey
839,200705_044_1,8,A,2626,3045,419,0.027292606,G,grey
840,200705_044_1,9,E,1682,2648,966,0.111651572,G,grey
841,200705_044_1,10,K,3206,3487,281,0.071953235,G,grey
842,200705_044_1,11,E,1965,2963,998,0.111651572,G,grey
843,200705_044_1,12,B,2244,2929,685,0.10668928,G,grey
844,200705_044_1,13,A,2204,2605,401,0.029773753,G,grey
845,200705_044_1,14,E,1602,2606,1004,0.089321258,G,grey
846,200705_044_3,1,K,2925,3167,242,0.082704868,G,grey
847,200705_044_3,2,A,2606,3165,559,0.021503266,G,grey
848,200705_044_3,3,E,1685,2843,1158,0.082704868,G,grey
849,200705_044_3,4,K,3287,3566,279,0.05623931,G,grey
850,200705_044_3,5,E,1881,2805,924,0.090975355,G,grey
851,200705_044_3,6,B,2403,3006,603,0.117440913,G,grey
852,200705_044_3,7,A,2364,2965,601,0.02481146,G,grey
853,200705_044_3,8,E,1602,2804,1202,0.112478621,G,grey
854,200705_044_3,9,K,3166,3608,442,0.061201602,G,grey
855,200705_044_3,10,E,1760,2925,1165,0.099245842,G,grey
856,200705_045_12,1,A,2206,2484,278,0.021503266,G,grey
857,200705_045_12,2,A,2284,2560,276,0.019849168,G,grey
858,200705_045_12,3,K,2925,3126,201,0.076088479,G,grey
859,200705_045_12,4,E,1362,2765,1403,0.145560568,G,grey
860,200705_045_12,5,A,2205,2604,399,0.02481146,G,grey
861,200705_045_12,6,D,1482,1923,441,0.044660629,G,grey
862,200705_045_12,7,K,2845,3088,243,0.086013063,G,grey
863,200705_045_12,8,E,1562,2725,1163,0.138944179,G,grey
864,200705_045_15,1,A,2165,2524,359,0.02481146,G,grey
865,200705_045_15,2,A,1642,2003,361,0.039698337,G,grey
866,200705_045_15,3,B,2645,3246,601,0.079396673,G,grey
867,200705_045_15,4,E,1601,2804,1203,0.15052286,G,grey
868,200705_045_15,5,A,2125,2805,680,0.023157363,G,grey
869,200705_045_15,6,A,1607,1762,155,0.043006531,G,grey
870,200705_045_15,7,B,2451,3326,875,0.081050771,G,grey
871,200705_045_15,8,E,1682,2688,1006,0.117440913,G,grey
872,200705_045_16,1,A,2084,2845,761,0.028119655,G,grey
873,200705_045_16,2,A,1963,2724,761,0.02481146,G,grey
874,200705_045_16,3,D,1445,2166,721,0.046314726,G,grey
875,200705_045_16,4,B,2525,3127,602,0.076088479,G,grey
876,200705_045_16,5,E,1519,2805,1286,0.155485152,G,grey
877,200705_045_16,6,A,2405,2724,319,0.034736045,G,grey
878,200705_045_16,7,D,1443,1842,399,0.041352434,G,grey
879,200705_045_16,8,B,2484,3086,602,0.077742576,G,grey
880,200705_045_16,9,E,1521,2805,1284,0.155485152,G,grey
881,200705_045_20,1,A,1805,2643,838,0.03142785,G,grey
882,200705_045_20,2,A,1734,2244,510,0.043006531,G,grey
883,200705_045_20,3,B,2685,3206,521,0.064509797,G,grey
884,200705_045_20,4,E,1440,2885,1445,0.143906471,G,grey
885,200705_045_20,5,A,2163,2364,201,0.036390142,G,grey
886,200705_045_20,6,B,2765,3246,481,0.061201602,G,grey
887,200705_045_20,7,E,1646,3003,1357,0.145560568,G,grey
888,200705_045_20,8,A,2084,2243,159,0.043006531,G,grey
889,200705_045_20,9,B,2925,3206,281,0.066163895,G,grey
890,200705_045_20,10,E,1480,3047,1567,0.148868763,G,grey
891,200705_047_2,1,A,1764,2443,679,0.03142785,G,grey
892,200705_047_2,2,D,1522,2044,522,0.041352434,G,grey
893,200705_047_2,3,K,2645,2966,321,0.072780284,G,grey
894,200705_047_2,4,E,1285,2885,1600,0.142252373,G,grey
895,200705_047_2,5,A,1763,2524,761,0.039698337,G,grey
896,200705_047_2,6,B,2527,3246,719,0.064509797,G,grey
897,200705_047_2,7,E,1442,2688,1246,0.148868763,G,grey
898,200705_047_2,8,D,1362,1963,601,0.041352434,G,grey
899,200705_047_2,9,K,2565,2965,400,0.082704868,G,grey
900,200705_047_2,10,E,1362,2887,1525,0.143906471,G,grey
901,200705_047_6,1,A,1763,2364,601,0.02481146,G,grey
902,200705_047_6,2,D,1522,2085,563,0.071126187,G,grey
903,200705_047_6,3,K,2645,3246,601,0.071126187,G,grey
904,200705_047_6,4,E,1519,2765,1246,0.148868763,G,grey
905,200705_047_6,5,D,1564,2362,798,0.051277018,G,grey
906,200705_047_6,6,K,2683,3006,323,0.086013063,G,grey
907,200705_047_6,7,E,1562,2807,1245,0.178642515,G,grey
908,200705_047_6,8,D,1402,2084,682,0.066163895,G,grey
909,200705_047_6,9,K,2645,3166,521,0.08766716,G,grey
910,200705_047_6,10,E,1562,2844,1282,0.173680223,G,grey
911,200705_047_8,1,A,1844,2363,519,0.029773753,G,grey
912,200705_047_8,2,A,1963,2244,281,0.044660629,G,grey
913,200705_047_8,3,B,2286,3125,839,0.08766716,G,grey
914,200705_047_8,4,E,1403,2685,1282,0.143906471,G,grey
915,200705_047_8,5,A,1804,2363,559,0.034736045,G,grey
916,200705_047_8,6,A,1482,1963,481,0.046314726,G,grey
917,200705_047_8,7,B,2164,2648,484,0.082704868,G,grey
918,200705_047_8,8,E,1522,2565,1043,0.165409736,G,grey
919,200705_048_8,1,A,2405,2764,359,0.028119655,G,grey
920,200705_048_8,2,E,1562,2527,965,0.064509797,G,grey
921,200705_048_8,3,B,2565,3170,605,0.114132718,G,grey
922,200705_048_8,4,A,2685,3086,401,0.033081947,G,grey
923,200705_048_8,5,E,1603,2645,1042,0.077742576,G,grey
924,200705_048_8,6,B,2588,3246,658,0.107516329,G,grey
925,200705_048_8,7,A,2726,3125,399,0.029773753,G,grey
926,200705_048_8,8,E,1521,2565,1044,0.072780284,G,grey
927,200705_048_10,1,A,2565,2925,360,0.02481146,G,grey
928,200705_048_10,2,@,1643,1963,320,0.092629452,G,grey
929,200705_048_10,3,A,2243,2406,163,0.023157363,G,grey
930,200705_048_10,4,@,1563,1962,399,0.129019594,G,grey
931,200705_048_10,5,B,2685,3169,484,0.110824523,G,grey
932,200705_048_10,6,A,2605,2885,280,0.029773753,G,grey
933,200705_048_10,7,E,1482,2605,1123,0.092629452,G,grey
934,200705_048_10,8,B,2566,3247,681,0.110824523,G,grey
935,200705_048_10,9,A,2525,2930,405,0.033081947,G,grey
936,200705_048_10,10,E,1763,2451,688,0.095937647,G,grey
937,200705_048_12,1,A,2405,2884,479,0.03142785,G,grey
938,200705_048_12,2,E,1963,2404,441,0.059547505,G,grey
939,200705_048_12,3,B,2407,3246,839,0.109170426,G,grey
940,200705_048_12,4,A,2364,2925,561,0.026465558,G,grey
941,200705_048_12,5,E,1723,2565,842,0.077742576,G,grey
942,200705_048_12,6,B,2601,3247,646,0.109170426,G,grey
943,200705_048_12,7,A,2482,3065,583,0.034736045,G,grey
944,200705_048_12,8,E,1603,2483,880,0.074434381,G,grey
945,200705_048_13,1,A,2125,2844,719,0.019849168,G,grey
946,200705_048_13,2,E,1725,2563,838,0.074434381,G,grey
947,200705_048_13,3,B,2566,3205,639,0.097591744,G,grey
948,200705_048_13,4,A,2362,3166,804,0.026465558,G,grey
949,200705_048_13,5,E,1643,2605,962,0.069472089,G,grey
950,200705_048_13,6,B,2604,3169,565,0.112478621,G,grey
951,200705_048_13,7,A,2439,3086,647,0.028119655,G,grey
952,200705_048_13,8,E,1763,2525,762,0.069472089,G,grey
953,200705_049_1,3,E,1362,2845,1483,0.147214665,G,grey
954,200705_049_1,4,A,2643,2527,-116,0.038044239,G,grey
955,200705_049_1,5,D,1522,1763,241,0.043006531,G,grey
956,200705_049_1,6,B,2284,3009,725,0.092629452,G,grey
957,200705_049_1,7,E,1402,2847,1445,0.143906471,G,grey
958,200705_049_1,8,A,1765,2563,798,0.033081947,G,grey
959,200705_049_1,9,D,1362,1960,598,0.046314726,G,grey
960,200705_049_1,10,B,2364,3046,682,0.084358966,G,grey
961,200705_049_1,11,E,1402,2845,1443,0.158793347,G,grey
962,200705_049_3,1,A,1885,2723,838,0.033081947,G,grey
963,200705_049_3,2,@,2041,2191,150,0.076088479,G,grey
964,200705_049_3,3,Z,1642,3050,1408,0.18195071,G,grey
965,200705_049_3,4,A,1681,2765,1084,0.039698337,G,grey
966,200705_049_3,5,H,1843,2244,401,0.08766716,G,grey
967,200705_049_3,6,Z,1803,3285,1482,0.173680223,G,grey
968,200705_049_4,1,A,2332,2606,274,0.02481146,G,grey
969,200705_049_4,2,@,2003,2204,201,0.071126187,G,grey
970,200705_049_4,3,Z,1606,3403,1797,0.185258905,G,grey
971,200705_049_4,4,A,1683,2605,922,0.043006531,G,grey
972,200705_049_4,5,@,2002,2164,162,0.0628557,G,grey
973,200705_049_4,6,Z,1761,3286,1525,0.173680223,G,grey
